1111111111111111111111111111111111
10000000000000000000000000P1000001
1010010100100000001001000111010101
1011011110101010001101000000010101
100101E0000000000C0000000000000001
1111111111111111111111111111111111