111111111111111111111111111111111111111
100000000000000C11100000000000000111111
10000000000000000010000000C000000111111
100000011110000111111111000000000111111
10000C000000000000100000111100000111111
10000000000001000C000000000100000111111
100000011111110000000000000100000111111
10100000000P0100000000000C0100000111111
101000000C00000000000000000000000111111
100110000000000000000000000001000111111
100011000000000000000000000011100111111
100001100000000000111000000001000111111
1001111110000000001C0000000000000111111
100000000000000000111000000000000111111
1C0000000000000000010100000000000111111
10000000000000111111010000000C000111111
101100000000000000000100000000000111111
1001000C00000000001111000000000E0111111
100100000000000000000000C00000000111111
111111111111111111111111111111111111111